11111111
10010001
100010E1
10000001
10101001
10100001
11111111